7 8 8 8 11 8 11 8 8 8 8 8 11 8 9
4 1 1 1 15 1 21 1 1 1 1 1 21 1 6
13 14 20 1 15 1 1 1 22 1 22 1 1 1 6
4 1 1 1 26 14 14 14 25 1 15 1 22 1 6
4 1 23 14 18 1 1 1 21 1 21 1 15 1 6
4 1 1 1 1 1 22 1 1 1 1 1 15 1 6
13 14 14 14 20 1 26 14 14 20 1 1 21 1 6
4 1 1 1 1 1 15 1 1 1 1 1 1 1 6
4 1 23 19 1 23 27 20 1 23 14 20 1 23 12
4 1 1 15 1 1 1 1 1 1 1 1 1 1 6
13 20 1 21 1 22 1 23 14 14 24 14 20 1 6
4 1 1 1 1 15 1 1 1 1 15 1 1 1 6
4 1 23 14 14 27 20 1 22 1 21 1 22 1 6
4 1 1 1 1 1 1 1 15 1 1 1 15 1 6
3 2 2 2 2 2 2 2 10 2 2 2 10 2 5
1 1 1 1 1 1 1 1 1 1 1 1 1 1 1